User = Користувач
with = з
this = цей
login = логін
is = є
already = вже
exists = існує
in = в
the = 
system = системі 
Please = будь ласка
use = використовуйте
another = інше
name = ім'я
for = для
Thank = дякую
you = 
Something = Щось 
went = пішло
wrong = не так
ID = порядковий номер
Guest = Гість
password = пароль
email = імейл
role = роль
Laptop = ноутбук
model = модель
of = 
laptop's = ноутбука
speed = швидкість
hard = хард
drive = диск
size = розмір
ram = рам
screen = екран
price = ціна
PC = комп'ютер
CD = дисковод
Printer = принтер
color = колір
type = тип
Product = продукт
marker = виробник
number = номер
Unfortunately = на жаль
Laptops = ноутбуки
by = 
requested = за запитом
criteria = критерію
are = є
not = не
avaliable = доступні
out = вийшов
IT = ІТ
Department = Відділ
PCs = Комп'ютери
our = наші
Company = Компанія
has = має
only = лише
Printers = Принтери
black = чорний
white = білий
doesn't = не
own = володіє
a = 
selected = виділені
range = проміжок
Choose = виберіть
preffered = бажану
cathegory = категорію
To = 
see = видно
information = інформація
press = натисніть
visiting = відвідування
Have = 
a = 
nice = гарного
day = дня
input = введіть
Try = спробуйте
again = знову
List = Список
manufacturers = виробників   
and = і
which = які
contains = вміщують
less = менше
then = ніж
Poducts = Товари
all = всі
exept = окрім